# Syntax Coloring Map For RPLidar Library

# Classes & Structs (KEYWORD1)
RPLidar	KEYWORD1
MeasurementData	KEYWORD1
LaserScanBatch	KEYWORD1
LaserScanBatchPool	KEYWORD1
DeviceInfo	KEYWORD1
DeviceHealth	KEYWORD1
DeviceScanRate	KEYWORD1
ResponseDescriptor	KEYWORD1

# Methods (KEYWORD2)
begin	KEYWORD2
end	KEYWORD2
stopScan	KEYWORD2
resetLidar	KEYWORD2
startExpressScan	KEYWORD2
getHealth	KEYWORD2
getInfo	KEYWORD2
startMotor	KEYWORD2
stopMotor	KEYWORD2
calculateRecommendedPoolSize	KEYWORD2

# Constants (LITERAL1)
CMD_SYNC_BYTE	LITERAL1
CMD_STOP	LITERAL1
CMD_RESET	LITERAL1
CMD_SCAN	LITERAL1
CMD_EXPRESS_SCAN	LITERAL1
CMD_FORCE_SCAN	LITERAL1
CMD_GET_INFO	LITERAL1
CMD_GET_HEALTH	LITERAL1
GET_SAMPLERATE	LITERAL1
GET_LIDAR_CONF	LITERAL1
SINGLE_RESP_MODE	LITERAL1
MULTI_RESP_MODE	LITERAL1
EXPRESS_TYPE_LEGACY	LITERAL1
EXPRESS_TYPE_EXTENDED	LITERAL1
RESP_TYPE_INFO	LITERAL1
RESP_TYPE_HEALTH	LITERAL1
RESP_TYPE_SCAN_RATE	LITERAL1
RESP_TYPE_SCAN	LITERAL1
RESP_TYPE_EXPRESS_LEGACY_SCAN	LITERAL1
RESP_TYPE_EXPRESS_EXTENDED_SCAN	LITERAL1
RESP_TYPE_EXPRESS_DENSE_SCAN	LITERAL1
RESP_SYNC_BYTE1	LITERAL1
RESP_SYNC_BYTE2	LITERAL1
MIN_QUALITY	LITERAL1
READ_TIMEOUT_MS	LITERAL1
READ_EXP_TIMEOUT_MS	LITERAL1
UART_BAUD_RATE	LITERAL1
RX_TIMEOUT_MS	LITERAL1
RING_BUFFER_SIZE	LITERAL1
UART_RX_BUF_SIZE	LITERAL1
SCANS_PER_PUBLISH	LITERAL1
MAX_MEASUREMENTS_PER_BATCH	LITERAL1